3 4
XXXX
XSGX
XXXX

5 5
XXXXX
XG  X
X S X
X  GX
XXXXX

6 6
XXXXXX
XG   X
X   XX
XX   SX
XXXXXX

6 6
XXXXXX
XGXXXX
X XXXX
X XXXX
X   SX
XXXXXX



4 4
XXXX
X GX
XS X
XXXX

6 6
XXXXXX
XG   X
XS   X
X    X
X   GX
XXXXXX